a=to
antes=before
barco=ship
borrar=delete
cafe=brown
casa=house
comprar=buy
con=with
contaminado=corrupt
de=of
despues=after
dos=two
el=the
en=in
energia=power
es=is
fallo=bug
hambre=hunger
interno=internal
la=the
los=the
memoria=memory
mi=my
mitad=half
muchachos=boys
necesita=necessary
nosotros=we
ordenador=computer
pantalla=screen
papel=paper
pelo=hair
quieres=want
quiero=want
rearrancar=reboot
su=your
tarde=afternoon
texto=text
tienen=have
tinta=ink
todas=all
tu=you
una=a
vacio=empty
vamos=go
virus=virus
yo=i
